Pallet Town
24,20
01,02,01,02,01,02,01,02,01,02,01,03,04,05,06,02,01,02,01,02,01,02,01,02
07,08,09,10,09,10,09,10,09,10,09,11,12,13,14,10,09,10,09,10,09,10,07,08
01,03,04,15,15,15,15,15,15,15,15,15,16,17,15,15,15,15,15,15,15,18,06,02
07,19,12,20,20,21,22,22,22,23,20,20,20,20,21,22,22,22,23,20,20,24,25,08
01,03,12,26,27,28,29,29,29,30,31,20,26,27,28,29,29,29,30,31,20,24,06,02
07,19,12,24,32,33,34,34,34,35,36,20,24,32,33,34,34,34,35,36,20,24,25,08
01,03,12,24,37,38,39,40,41,42,36,20,24,37,38,39,40,41,42,36,20,24,06,02
07,19,12,24,43,44,45,46,47,48,36,20,24,43,44,45,46,47,48,36,20,24,25,08
01,03,12,49,15,50,20,49,15,15,50,20,49,15,50,20,49,15,15,50,20,24,06,02
07,19,12,20,20,20,20,20,20,20,20,20,20,51,52,52,52,52,53,54,20,24,25,08
01,03,12,20,20,20,20,20,20,20,20,20,26,55,56,56,56,56,57,58,59,24,06,02
07,19,12,20,26,60,60,60,60,61,31,20,24,62,63,63,63,63,64,65,12,24,25,08
01,03,12,20,24,66,66,66,66,32,36,20,24,67,68,69,70,71,72,73,12,24,06,02
07,19,12,20,24,66,66,66,66,74,36,20,24,75,76,77,78,79,80,81,12,24,25,08
01,03,12,20,24,82,83,32,83,32,36,20,49,15,15,50,20,49,15,15,84,24,06,02
07,19,12,20,49,15,15,15,15,15,50,20,26,27,27,27,27,27,27,31,20,24,25,08
01,03,12,20,20,20,20,20,20,20,20,20,85,86,86,86,61,86,86,87,20,24,06,02
07,19,88,27,27,27,27,89,90,90,91,20,20,20,20,20,20,20,20,20,20,24,25,08
01,03,32,32,83,32,83,92,93,93,94,27,27,27,27,27,27,27,27,27,27,95,06,02
07,19,96,97,96,97,74,92,93,93,94,32,74,32,74,32,74,32,96,97,96,97,25,08